        

N          ./path_to_the_north_texture       



S          ./path_to_the_south_texture


W            ./path_to_the_west_texture



E                ./path_to_the_east_texture


F 220,10,255    
C     225   ,30   , 0

        1111111111111111111111111
        10000000011000000000000001
       11011000001110000000000001
        1001000000000000000000001
111111111011000001110000000000001
10000000001100000111011111111111
11110111111111011100000010001    
11110111111111011101010010001
11000000110101011100000010001
1000000000000000110000010001
10000000000000011100000000111         1
1100000111010101 111011110N0111    111011
11110111 1110101 101111010001         1
11111111 1111111 111111111111