        

N    ./path_to_the_north_texture       


S          ./path_to_the_south_texture
W            ./path_to_the_west_texture
E         ./path_to_the_east_texture
C                225,30,123
F             100,10,255    










        1111111111111111111111111
        10000000011000000000000001
       11011000001110000000000001
        1001000000000000000000001
11111111101100000111111000000001
100000000011000001    11111111111
111101111111110111    1010001 
111101111111110111    1010001
11000000110101011111111010001
1000000000000001100000100011
10000000E00000011100000000111111   
1100000111010101 11101111001     
11110111 1110101 10111101000111   
11111111 1111111 111111111111


