N    ./textures/north.xpm      


S          ./textures/south.xpm
W            ./textures/west.xpm
E         ./textures/east.xpm
C                0, 76,153
F          96,96,96

  
111111111111111111111
100000000000000000001
100000000000000000001
100000000000000000001
100000000000000000001
100000000000000000001
100000000000000000001
100000000000000000001
100000000000000000001
100000000000000000001
100000000000000000001
100000000000000000001
100000000000000000001
100000000000000000001
100000000000000000001
100000000000000000001
100000000000000000001
100000000000000000001
100000000000000000001
1000000000000000000N1
111111111111111111111
