        

N    ./textures/north.xpm      


S          ./textures/south.xpm
W            ./textures/west.xpm
E         ./textures/east.xpm
C                0, 76,153
F          96,96,96

  
1111111111
1000100001
1000200101
10001N0101
1111111111