        

N    ./path_to_the_north_texture       


S          ./path_to_the_south_texture
W            ./path_to_the_west_texture
E         ./path_to_the_east_texture
C                0, 76,153
F          96,96,96

  
1111111111
1000000001
1N00000001
1000000001
1111111111