        

N    ./path_to_the_north_texture       


S          ./path_to_the_south_texture
W            ./path_to_the_west_texture
E         ./path_to_the_east_texture
C                95,180,255
F          153,219,175 


1111111111
1000000001
1000000001
10000N0001
1000000111
1100000001
1111111111