        

N    ./path_to_the_north_texture       


S          ./path_to_the_south_texture
W            ./path_to_the_west_texture
E         ./path_to_the_east_texture
C                95,180,255
F          153,219,175 


111111111
100000001
101000101
1000S0001
101000101
100000001
111111111